15555555955555552
7990999090999099,
7990999090999099,
7000000000000000,
7990909999909099,
3--09000900090--4
0007999090999,000
000790--0--09,000
0007980000079,000
55500800000700555
+++7980000079,+++
0007905555509,000
0007909999909,000
15500000900000552
7990999090999099,
7090000000000090,
90909099999090909
7000900090009000,
7999999090999999,
3---------------4
