00000000100000000
01101110101110110
01101110101110110
00000000000000000
01101011111010110
00001000100010000
00001110101110000
00001000000010000
00001000000010000
00000000000000000
00001000000010000
00001033333010000
00001011111010000
33300000100000333
01101110101110110
00100000000000100
10101011111010101
00001000100010000
01111110101111110
